..........................
..........................
%%%%......######......%%%%
%%%%....##########....%%%%
%%.....############.....%%
%%.....############.....%%
......####%%##%%####......
......####%%##%%####......
......##%%%%##%%%%##......
......##%%%%##%%%%##......
%%....##############....%%
%%....##############....%%
%%%%....##%%##%%##....%%%%
%%%%....##%%##%%##....%%%%
~~~~~~..##########..~~~~~~
~~~~~~..##########..~~~~~~
.........#.#.#.#.#........
.........#.#.#.#.#........
........#.#.#.#.#.........
........#.#.#.#.#.........
.@.@.@..............@.@.@.
.@.@.@..............@.@.@.
#.#.#................#.#.#
#.#.#................#.#.#
@.@.@..@..........@..@.@.@
@.@.@..@..........@..@.@.@