........####....##........
........####....##........
..%%%%####......##........
..%%%%####......##........
%%%%%%%%%%%%%%%%####......
%%%%%%%%%%%%%%%%####......
%%@@##%%######%%%%%%%%##@@
%%..##%%######%%%%%%%%##@@
%%%%##%%%%%%@@%%%%##@.##..
%%%%##%%%%%%..%%%%##@.##..
..%%%%##..%%%%%%%%##..##..
..%%%%##@@%%%%%%%%##..##..
..##########%%%%#####.%%%%
..##########%%%%#####.%%%%
.@@@####......####......%%
.@..####......##........%%
..##..##......##%%%%###.%%
..##..##....##..%%%%###.%%
..##......@@##%%%%##....%%
..##.....###..%%%%##....%%
..#####..###%%%%..%%##%%%%
..#####..###%%%%##%%##%%%%
....##...#......##%%##%%..
....##..%%......##%%..%%..
....##..%%........%%%%%%..
..................%%%%%%..