..........................
..........................
....@@%%@@................
....@@%%@@................
......%%..%%..............
......%%..%%@@............
..%%........%%............
..%%........%%##..........
..%%%%....%%..%%..........
..%%%%....%%..%%@@........
..%%..%%..%%....%%........
..%%..%%..%%....%%##......
..%%....%%......%%%%......
..%%....%%......%%%%@@....
....%%........%%%%%%%%....
....%%........%%%%%%%%##..
......%%....%%..%%%%%%%%..
......%%....%%..%%%%%%%%..
##..........%%....%%%%%%@@
##..........%%....%%%%%%@@
####..........%%..%%%%%%%%
####..........%%..%%%%%%%%
@@####..........%%..%%%%%%
@@####..........%%..%%%%%%
@@@@####........%%....%%%%
@@@@####........%%....%%%%