..........................
......######....##........
....################......
..##################......
..%%%%%%%%%%%%%%%%####....
..%%%%%%%%%%%%%%%%####....
%%%%............%%%%####..
%%%%............%%%%####..
%%..@@....@@......%%%%%%..
%%..@@....@@......%%%%%%..
%%..@@....@@......%%%%%%..
%%..@@....@@......%%%%%%..
%%....%%........%%%%#####.
%%....%%........%%%%#####.
%%%%%%%%%%%%%%%%%%#######.
%%%%%%%%%%%%%%%%%%#######.
##%%%%####%%%%%%########..
##%%%%####%%%%%%########..
..####################..@@
..####################..@@
@@..##@@#############...@@
@@..##@@#############...@@
..@@####@@......####@@@@@@
..@@##..@@......####@@@@@@
..........................
..........................