..........%%..............
..........%%..............
........%%@@%%............
........%%@@%%............
....%%....%%....%%%%......
....%%....%%....%%%%......
..%%##%%......%%####%%....
..%%##%%......%%####%%....
....%%##%%......%%%%....%%
....%%##%%......%%%%....%%
%%....%%....%%........%%@@
%%....%%....%%........%%@@
##%%......%%@@%%....%%..%%
##%%......%%@@%%....%%..%%
@@##%%......%%....%%@@%%..
@@##%%......%%....%%@@%%..
##%%....%%......%%..%%....
##%%....%%......%%..%%....
%%....%%##%%..%%##%%......
%%....%%##%%..%%##%%......
......%%##%%....%%....%%..
......%%##%%....%%....%%..
..%%....%%..........%%@@%%
..%%....%%..........%%@@%%
%%@@%%............%%##%%..
%%@@%%............%%##%%..