....@@..##@@.........#....
....@@..##...........#....
....##..##%%..########....
....##..##%%....######....
..%%%%..##%%.##.......@@@@
..%%%%..##%%.##.......@@@@
%%%%%%%%%%%%######...###..
%%%%%%%%%%%%######...###..
....%%%%....@@##...#####.#
....%%%%####..##...###...#
##@@....####......####...#
##....##..........##.....#
.#....##------------------
.#..####------------------
.#..##..------------------
.#......------------------
....@@..------------------
....@@..------------------
##..##..------------------
##..##..------------------
.#..##..------------------
.#..##..------------------
.#..##..........----------
.#..##..........----------
....##............--------
..................--------