....~~~~..................
....~~~~..................
......~~%%..#.............
@@....~~%%..#.............
%%..........@...#...~~~~..
%%@@........@...#...~~~~..
%%%%..@@...#....@.%%~~....
%%%%....##.#....@.%%~~....
%%%%%%....@@...#..........
%%%%%%....@@##.#........@@
%%%%@@.....#..@@........%%
%%%%..@@...#..@@##....@@%%
%%@@....##@@...#..@@..%%%%
%%........@@...#......%%%%
..........#.##@@....%%%%%%
..........#...@@....%%%%%%
....~~%%.@....#.##..@@%%%%
....~~%%.@....#...@@..%%%%
..~~~~...#...@..........%%
..~~~~...#...@..........%%
.............#..%%~~....@@
.............#..%%~~......
@@................~~~~....
@@................~~~~....
@@@@....................@@
@@@@....................@@