........@@................
........@@................
@@@@....@@....@@@@........
@@@@....@@....@@@@........
..@@....@@......@@..@@@@%%
..@@....@@......@@..@@@@%%
..@@....@@@@@@..%%..@@....
..@@....@@@@@@..%%..@@....
..##........@@..@@@@@@....
..##........@@..@@@@@@....
%%@@@@..@@##@@####........
%%@@@@..@@##@@####........
....@@%%@@%%....##....@@@@
....@@%%@@%%....##....@@@@
....@@....%%....@@....@@..
....@@....%%....@@....@@..
....##....@@....@@@@##@@..
....##....@@....@@@@##@@..
%%@@@@@@%%%%##@@@@..##@@..
%%@@@@@@%%%%##@@@@..##@@..
......##........%%%%..##..
......##........%%%%..##..
......@@..........%%..##..
......@@..........%%..##..
......@@..........@@..##..
......@@..........@@..##..