......~~........~~........
......~~........~~........
~~~~..~~..~~~~~~~~..~~~~~~
~~~~..~~..~~~~~~~~..~~~~~~
%%%%##....##....~~..~~%%~~
%%%%##....##....~~..~~%%~~
%%~~~~~~~~..@@....##%%%%%%
%%~~~~~~~~..@@....##%%%%%%
%%%%..~~....~~..~~~~~~~~%%
%%%%..~~....~~..~~~~~~~~%%
~~~~..~~..~~~~....~~......
~~~~..~~..~~~~....~~......
....##%%##..##%%..~~....~~
....##%%##..##%%..~~....~~
..~~~~%%~~~~~~~~..%%##..~~
..~~~~%%~~~~~~~~..%%##..~~
##....##....~~..%%%%~~..~~
##....##....~~..%%%%~~..~~
~~~~..~~~~..~~##~~~~~~....
~~~~..~~~~..~~##~~~~~~....
....##..%%%%....%%~~....~~
....##..%%%%....%%~~....~~
..~~~~~~%%........~~..~~~~
..~~~~~~%%........~~..~~~~
..~~......................
..~~......................