------------..------------
------------..------------
--------------------------
--------------------------
------##----------##------
------##----------##------
--##..##..##--##..##..##--
--##..##..##--##..##..##--
--######..........######--
--....##..........##------
------##..##@@##..##------
------######@@######------
@@------..@@..@@..------@@
@@------..........------@@
--------..........--------
--------..##..##..--------
--------..##..##..--------
--------..##..##..--------
------##..........##------
------##....##....##------
--##--##..@@@@@@..##--##--
--##--##..........##--##--
..##..##..........##..##..
..######..........######..
..##..................##..
..........................