..............@@@@........
..........................
....@@@@@@@@........@@....
....@@..............@@....
....@@......%%..@@@@@@....
....@@......%%....@@@@....
..@@......%%@@......@@....
..@@......%%@@......@@....
........%%@@@@......@@@@..
........%%@@@@........@@..
..@@..%%@@@@@@..@@........
..@@..%%@@@@@@..@@........
...@..@@@@......@@@@......
...@..@@@@......@@@@......
@.......@@..@@@@@@.....@..
@.......@@..@@@@@@.....@..
...@@@......@@@@%%....@@..
...@@@......@@@@%%....@@..
..@@........@@%%....@@@@..
..@@........@@%%....@@@@..
..@@@@@@....%%....@@......
......@@....%%....@@......
..................@@....@@
......................@@@@
..........................
@@@@......................